![WordData]
!Update=2012-09-23
!Develope=MayTryArk(jiun0623@naver.com)

[Time]
one=1,일,하나,한
two=2,이,둘,두
three=3,삼,셋,세
four=4,사,넷,네
five=5,오,다섯,다섯
six=6,육,여섯,여섯
seven=7,칠,일곱,일곱
eight=8,팔,여덟,여덟
nine=9,구,아홉,아홉
ten=10,십,열,열
eleven=11,십일,열하나,열한
tweleve=12,십이,열둘,열두
Clock=시계
OClock=시
hour=시
minute=분
second=초
year=년
month=월
day=일
Monday=월요일
Tuesday=화요일
Wednesday=수요일
Thursday=목요일
Friday=금요일
Saturday=토요일
Sunday=일요일
January=1월
February=2월
March=3월
April=4월
May=5월
June=6월
July=7월
August=8월
September=9월
October=10월
November=11월
December=12월
Tonight=밤
Mon=월
Tue=화
Wed=수
Thu=목
Fri=금
Sat=토
Sun=일
Januaryshort=1.
Februaryshort=2.
Marchshort=3.
Aprilshort=4.
Mayshort=5.
Juneshort=6.
Julyshort=7.
Augustshort=8.
Septembershort=9.
Octobershort=10.
Novembershort=11.
Decembershort=12.

[Remind]
alarm=알람
Set=설정
setting=설정
option=옵션
Snooze=반복 알람
new=새,새로운
music=음악
[CrisWordData]


programs=프로그램
systemtools=시스템 도구
alarm=알람
Set=설정
setting=설정
option=옵션
Snooze=반복 알람
Videos=비디오
Music=음악
TV=TV
Pictures=이미지,사진
openfolder=폴더 열기
new=새
applications=어플리케이션
edit=수정하기
game=게임
note=노트
memo=메모
ControlPanel=제어판
Devices=장치 관리자
Sound=소리
Gamesexplorer=게임 폴더
Friends=친구
internetshortcuts=사이트 바로가기
People=사람들
Size=크기
Battery=배터리
Power=전원,파워
Usetime=컴퓨터 사용시간
Memory=메모리
CORE=CPU
harddrives=하드디스크
Free=남음,빈,공짜
Space=용량,공간
Used=사용 중,사용 됨
tools=도구
download=다운로드
Network=네트워크
Setaswallpaper=바탕화면으로 설정
RecycleBin=휴지통
MostlyCloudy=구름 많음
LightSnow=가랑눈
LightRain=가랑비
Cloudy=흐림
Drizzle=이슬비
And=그리고
Partly=약간
Mostly=대체로
with=함께
Clear=맑음
Fair=맑음
PartlyCloudy=약간 흐림
Cloudy=흐림
FreezingRain=얼음비
Rain=비
Thunder=천둥
intheVicinity=근처
Shower=소나기
Snow=눈
Sunny=화창함
Windy=바람
Haze=실안개
Fog=안개
WidespreadDust=황사
Set=설정
T-Storm=뇌우
LightDrizzle=가랑비
WintryMiX=진눈깨비
Light=가벼운
Updates=업데이트
Currentversion=현재 버전
news=뉴스
feed=피드
BinaryClock=이진법 시계
countdown=카운트다운
start=시작
stop=그만,멈춤,정지
reset=리셋,다시시작
IP=IP
Empty=Empty,빔,빈
Processor=CPU
Volume=소리,음량
systeminfo=시스템 정보
ME=ME
Wireless=무선
Folders=폴더
Maps=지도
Search=검색
Stocks=주식
Calculator=계산
Camera=카메라
world=세계
Local=현지,지역
Select=선택
Radio=라디오
Playlists=재생 목록
Style=테마
Sleep=대기 모드
Logoff=로그오프
Shutdown=끄기
Restart=다시 시작
Hibernate=최대 절전
cancel=취소
WeatherForecast=일기 예보
Lock=잠금
Headers=헤더
Goodmorning=안녕하세요
Goodafternoon=안녕하세요
Goodevening=안녕하세요
Pressure=기압,압력
Connected=연결됨
Desktop=바탕화면
Finance=금융
default=[기본]
Font=글꼴
Wifi=Wi-Fi
Mute=음소거
brightness=밝기
##